0000000000000000000000000000000000000000000000000000000000000000000000000000000000000000000
0000000000000000000000000000000000000000000000000000000000000000000000000000000000000000000
0000000000000000000000000000000000000000000000000000000000000000000000000000000000000000000
0000000222222200000000000000000000000000000000000000000000000000000000000000000000000000000
0000000000000000000000000000000000000000000000000000000000000000000000000000000000000000000
0000000000000000000000000000000000000000000000000000000000000000000000000000000000000000000
2200000000000000000000000000000000002200000000000000000000000000000000000000000000000000000
1122222222222222222222222222222222221100002211200000022222222222222222222222222222222222222
1111111111111111111111111111111111111100001111100000011111111111111111111111111111111111111
1111111111111111111111111111111111111100000110000000011111111111111111111111111111111111111
1111111111111111111111111111111111111100000100000000011111111111111111111111111111111111111
1111111111111111111111111111111111111100000100000000011111111111111111111111111111111111111
1111111111111111111111111111111111111100000000000000011111111111111111111111111111111111111
1111111111111111111111111111111111111100000000000000011111111111111111111111111111111111111
1111111111111111111111111111111111111100000000000000011111111111111111111111111111111111111
1111111111111111111111111111111111111100000000000000011111111111111111111111111111111111111
1111111111111111111111111111111111111100000000000000011111111111111111111111111111111111111
